year,round,race_name,circuit_id,circuit_name,date,Other,Race Incident/Crash,Race Status,Technical Failure,Total,Total_Retirements
1994,1,Brazilian Grand Prix,interlagos,Autódromo José Carlos Pace,1994-03-27,0,9,12,5,26,14
1994,2,Pacific Grand Prix,okayama,Okayama International Circuit,1994-04-17,0,7,11,8,26,15
1994,3,San Marino Grand Prix,imola,Autodromo Enzo e Dino Ferrari,1994-05-01,2,8,12,5,27,13
1994,4,Monaco Grand Prix,monaco,Circuit de Monaco,1994-05-15,3,5,11,7,26,12
1994,5,Spanish Grand Prix,catalunya,Circuit de Barcelona-Catalunya,1994-05-29,1,3,10,13,27,16
1994,6,Canadian Grand Prix,villeneuve,Circuit Gilles Villeneuve,1994-06-12,1,4,14,7,26,11
1994,7,French Grand Prix,magny_cours,Circuit de Nevers Magny-Cours,1994-07-03,0,6,10,10,26,16
1994,8,British Grand Prix,silverstone,Silverstone Circuit,1994-07-10,1,0,16,9,26,9
1994,9,German Grand Prix,hockenheimring,Hockenheimring,1994-07-31,0,10,8,8,26,18
1994,10,Hungarian Grand Prix,hungaroring,Hungaroring,1994-08-14,0,7,11,8,26,15
1994,11,Belgian Grand Prix,spa,Circuit de Spa-Francorchamps,1994-08-28,1,3,12,10,26,13
1994,12,Italian Grand Prix,monza,Autodromo Nazionale di Monza,1994-09-11,0,8,9,9,26,17
1994,13,Portuguese Grand Prix,estoril,Autódromo do Estoril,1994-09-25,1,4,16,5,26,9
1994,14,European Grand Prix,jerez,Circuito de Jerez,1994-10-16,0,2,19,5,26,7
1994,15,Japanese Grand Prix,suzuka,Suzuka Circuit,1994-11-06,0,9,13,4,26,13
1994,16,Australian Grand Prix,adelaide,Adelaide Street Circuit,1994-11-13,0,5,11,10,26,15
1995,1,Brazilian Grand Prix,interlagos,Autódromo José Carlos Pace,1995-03-26,0,4,10,12,26,16
1995,2,Argentine Grand Prix,galvez,Autódromo Juan y Oscar Gálvez,1995-04-09,2,9,9,6,26,15
1995,3,San Marino Grand Prix,imola,Autodromo Enzo e Dino Ferrari,1995-04-30,2,3,14,7,26,10
1995,4,Spanish Grand Prix,catalunya,Circuit de Barcelona-Catalunya,1995-05-14,1,0,15,10,26,10
1995,5,Monaco Grand Prix,monaco,Circuit de Monaco,1995-05-28,2,5,10,9,26,14
1995,6,Canadian Grand Prix,villeneuve,Circuit Gilles Villeneuve,1995-06-11,0,6,9,9,24,15
1995,7,French Grand Prix,magny_cours,Circuit de Nevers Magny-Cours,1995-07-02,1,4,16,3,24,7
1995,8,British Grand Prix,silverstone,Silverstone Circuit,1995-07-16,0,7,11,6,24,13
1995,9,German Grand Prix,hockenheimring,Hockenheimring,1995-07-30,0,1,9,14,24,15
1995,10,Hungarian Grand Prix,hungaroring,Hungaroring,1995-08-13,0,2,11,11,24,13
1995,11,Belgian Grand Prix,spa,Circuit de Spa-Francorchamps,1995-08-27,0,4,14,6,24,10
1995,12,Italian Grand Prix,monza,Autodromo Nazionale di Monza,1995-09-10,0,9,10,5,24,14
1995,13,Portuguese Grand Prix,estoril,Autódromo do Estoril,1995-09-24,1,2,17,4,24,6
1995,14,European Grand Prix,nurburgring,Nürburgring,1995-10-01,0,5,15,4,24,9
1995,15,Pacific Grand Prix,okayama,Okayama International Circuit,1995-10-22,0,2,17,5,24,7
1995,16,Japanese Grand Prix,suzuka,Suzuka Circuit,1995-10-29,0,8,12,4,24,12
1995,17,Australian Grand Prix,adelaide,Adelaide Street Circuit,1995-11-12,2,7,8,7,24,14
1996,1,Australian Grand Prix,albert_park,Albert Park Grand Prix Circuit,1996-03-10,0,3,11,6,20,9
1996,2,Brazilian Grand Prix,interlagos,Autódromo José Carlos Pace,1996-03-31,0,7,11,4,22,11
1996,3,Argentine Grand Prix,galvez,Autódromo Juan y Oscar Gálvez,1996-04-07,0,4,10,8,22,12
1996,4,European Grand Prix,nurburgring,Nürburgring,1996-04-28,2,2,13,3,20,5
1996,5,San Marino Grand Prix,imola,Autodromo Enzo e Dino Ferrari,1996-05-05,0,2,9,10,21,12
1996,6,Monaco Grand Prix,monaco,Circuit de Monaco,1996-05-19,2,13,3,4,22,17
1996,7,Spanish Grand Prix,catalunya,Circuit de Barcelona-Catalunya,1996-06-02,1,10,6,3,20,13
1996,8,Canadian Grand Prix,villeneuve,Circuit Gilles Villeneuve,1996-06-16,0,4,8,10,22,14
1996,9,French Grand Prix,magny_cours,Circuit de Nevers Magny-Cours,1996-06-30,1,0,12,9,22,9
1996,10,British Grand Prix,silverstone,Silverstone Circuit,1996-07-14,0,0,11,9,20,9
1996,11,German Grand Prix,hockenheimring,Hockenheimring,1996-07-28,0,2,12,5,19,7
1996,12,Hungarian Grand Prix,hungaroring,Hungaroring,1996-08-11,0,5,8,7,20,12
1996,13,Belgian Grand Prix,spa,Circuit de Spa-Francorchamps,1996-08-25,0,5,10,4,19,9
1996,14,Italian Grand Prix,monza,Autodromo Nazionale di Monza,1996-09-08,0,6,9,5,20,11
1996,15,Portuguese Grand Prix,estoril,Autódromo do Estoril,1996-09-22,0,3,16,1,20,4
1996,16,Japanese Grand Prix,suzuka,Suzuka Circuit,1996-10-13,0,3,13,3,19,6
1997,1,Australian Grand Prix,albert_park,Albert Park Grand Prix Circuit,1997-03-09,0,5,9,8,22,13
1997,2,Brazilian Grand Prix,interlagos,Autódromo José Carlos Pace,1997-03-30,0,1,17,4,22,5
1997,3,Argentine Grand Prix,galvez,Autódromo Juan y Oscar Gálvez,1997-04-13,0,5,9,8,22,13
1997,4,San Marino Grand Prix,imola,Autodromo Enzo e Dino Ferrari,1997-04-27,0,4,11,7,22,11
1997,5,Monaco Grand Prix,monaco,Circuit de Monaco,1997-05-11,0,12,10,0,22,12
1997,6,Spanish Grand Prix,catalunya,Circuit de Barcelona-Catalunya,1997-05-25,0,1,15,6,22,7
1997,7,Canadian Grand Prix,villeneuve,Circuit Gilles Villeneuve,1997-06-15,0,6,10,6,22,12
1997,8,French Grand Prix,magny_cours,Circuit de Nevers Magny-Cours,1997-06-29,0,6,11,5,22,11
1997,9,British Grand Prix,silverstone,Silverstone Circuit,1997-07-13,0,2,10,10,22,12
1997,10,German Grand Prix,hockenheimring,Hockenheimring,1997-07-27,0,5,11,6,22,11
1997,11,Hungarian Grand Prix,hungaroring,Hungaroring,1997-08-10,0,3,12,7,22,10
1997,12,Belgian Grand Prix,spa,Circuit de Spa-Francorchamps,1997-08-24,1,4,15,2,22,6
1997,13,Italian Grand Prix,monza,Autodromo Nazionale di Monza,1997-09-07,0,3,14,5,22,8
1997,14,Austrian Grand Prix,red_bull_ring,Red Bull Ring,1997-09-21,1,3,13,5,22,8
1997,15,Luxembourg Grand Prix,nurburgring,Nürburgring,1997-09-28,0,4,10,8,22,12
1997,16,Japanese Grand Prix,suzuka,Suzuka Circuit,1997-10-12,2,2,12,6,22,8
1997,17,European Grand Prix,jerez,Circuito de Jerez,1997-10-26,0,2,17,3,22,5
1998,1,Australian Grand Prix,albert_park,Albert Park Grand Prix Circuit,1998-03-08,0,3,9,10,22,13
1998,2,Brazilian Grand Prix,interlagos,Autódromo José Carlos Pace,1998-03-29,2,2,10,8,22,10
1998,3,Argentine Grand Prix,galvez,Autódromo Juan y Oscar Gálvez,1998-04-12,0,3,14,5,22,8
1998,4,San Marino Grand Prix,imola,Autodromo Enzo e Dino Ferrari,1998-04-26,0,3,10,9,22,12
1998,5,Spanish Grand Prix,catalunya,Circuit de Barcelona-Catalunya,1998-05-10,0,2,16,3,21,5
1998,6,Monaco Grand Prix,monaco,Circuit de Monaco,1998-05-24,0,3,11,7,21,10
1998,7,Canadian Grand Prix,villeneuve,Circuit Gilles Villeneuve,1998-06-07,0,6,10,6,22,12
1998,8,French Grand Prix,magny_cours,Circuit de Nevers Magny-Cours,1998-06-28,0,1,15,6,22,7
1998,9,British Grand Prix,silverstone,Silverstone Circuit,1998-07-12,0,10,9,3,22,13
1998,10,Austrian Grand Prix,red_bull_ring,Red Bull Ring,1998-07-26,0,6,12,4,22,10
1998,11,German Grand Prix,hockenheimring,Hockenheimring,1998-08-02,0,0,16,5,21,5
1998,12,Hungarian Grand Prix,hungaroring,Hungaroring,1998-08-16,0,0,15,6,21,6
1998,13,Belgian Grand Prix,spa,Circuit de Spa-Francorchamps,1998-08-30,0,12,8,2,22,14
1998,14,Italian Grand Prix,monza,Autodromo Nazionale di Monza,1998-09-13,0,3,13,6,22,9
1998,15,Luxembourg Grand Prix,nurburgring,Nürburgring,1998-09-27,0,0,16,6,22,6
1998,16,Japanese Grand Prix,suzuka,Suzuka Circuit,1998-11-01,0,3,12,6,21,9
1999,1,Australian Grand Prix,albert_park,Albert Park Grand Prix Circuit,1999-03-07,0,4,8,10,22,14
1999,2,Brazilian Grand Prix,interlagos,Autódromo José Carlos Pace,1999-04-11,0,3,8,10,21,13
1999,3,San Marino Grand Prix,imola,Autodromo Enzo e Dino Ferrari,1999-05-02,0,7,9,6,22,13
1999,4,Monaco Grand Prix,monaco,Circuit de Monaco,1999-05-16,0,4,8,10,22,14
1999,5,Spanish Grand Prix,catalunya,Circuit de Barcelona-Catalunya,1999-05-30,1,1,12,8,22,9
1999,6,Canadian Grand Prix,villeneuve,Circuit Gilles Villeneuve,1999-06-13,0,6,10,6,22,12
1999,7,French Grand Prix,magny_cours,Circuit de Nevers Magny-Cours,1999-06-27,1,5,11,5,22,10
1999,8,British Grand Prix,silverstone,Silverstone Circuit,1999-07-11,0,0,16,6,22,6
1999,9,Austrian Grand Prix,red_bull_ring,Red Bull Ring,1999-07-25,0,2,13,7,22,9
1999,10,German Grand Prix,hockenheimring,Hockenheimring,1999-08-01,0,3,10,9,22,12
1999,11,Hungarian Grand Prix,hungaroring,Hungaroring,1999-08-15,0,1,16,5,22,6
1999,12,Belgian Grand Prix,spa,Circuit de Spa-Francorchamps,1999-08-29,0,1,16,5,22,6
1999,13,Italian Grand Prix,monza,Autodromo Nazionale di Monza,1999-09-12,1,6,10,5,22,11
1999,14,European Grand Prix,nurburgring,Nürburgring,1999-09-26,0,6,9,7,22,13
1999,15,Malaysian Grand Prix,sepang,Sepang International Circuit,1999-10-17,0,4,11,7,22,11
1999,16,Japanese Grand Prix,suzuka,Suzuka Circuit,1999-10-31,1,0,13,8,22,8
2000,1,Australian Grand Prix,albert_park,Albert Park Grand Prix Circuit,2000-03-12,1,1,9,11,22,12
2000,2,Brazilian Grand Prix,interlagos,Autódromo José Carlos Pace,2000-03-26,3,1,10,8,22,9
2000,3,San Marino Grand Prix,imola,Autodromo Enzo e Dino Ferrari,2000-04-09,0,2,14,6,22,8
2000,4,British Grand Prix,silverstone,Silverstone Circuit,2000-04-23,0,1,17,4,22,5
2000,5,Spanish Grand Prix,catalunya,Circuit de Barcelona-Catalunya,2000-05-07,0,3,16,3,22,6
2000,6,European Grand Prix,nurburgring,Nürburgring,2000-05-21,0,7,9,5,21,12
2000,7,Monaco Grand Prix,monaco,Circuit de Monaco,2000-06-04,1,7,9,5,22,12
2000,8,Canadian Grand Prix,villeneuve,Circuit Gilles Villeneuve,2000-06-18,0,4,13,5,22,9
2000,9,French Grand Prix,magny_cours,Circuit de Nevers Magny-Cours,2000-07-02,0,3,15,4,22,7
2000,10,Austrian Grand Prix,red_bull_ring,Red Bull Ring,2000-07-16,0,5,12,5,22,10
2000,11,German Grand Prix,hockenheimring,Hockenheimring,2000-07-30,0,6,11,5,22,11
2000,12,Hungarian Grand Prix,hungaroring,Hungaroring,2000-08-13,0,0,16,6,22,6
2000,13,Belgian Grand Prix,spa,Circuit de Spa-Francorchamps,2000-08-27,0,1,17,4,22,5
2000,14,Italian Grand Prix,monza,Autodromo Nazionale di Monza,2000-09-10,0,9,12,1,22,10
2000,15,United States Grand Prix,indianapolis,Indianapolis Motor Speedway,2000-09-24,0,2,12,8,22,10
2000,16,Japanese Grand Prix,suzuka,Suzuka Circuit,2000-10-08,0,2,15,5,22,7
2000,17,Malaysian Grand Prix,sepang,Sepang International Circuit,2000-10-22,0,3,12,7,22,10
2001,1,Australian Grand Prix,albert_park,Albert Park Grand Prix Circuit,2001-03-04,0,3,13,6,22,9
2001,2,Malaysian Grand Prix,sepang,Sepang International Circuit,2001-03-18,0,4,14,4,22,8
2001,3,Brazilian Grand Prix,interlagos,Autódromo José Carlos Pace,2001-04-01,0,6,10,6,22,12
2001,4,San Marino Grand Prix,imola,Autodromo Enzo e Dino Ferrari,2001-04-15,0,0,12,10,22,10
2001,5,Spanish Grand Prix,catalunya,Circuit de Barcelona-Catalunya,2001-04-29,0,2,15,5,22,7
2001,6,Austrian Grand Prix,red_bull_ring,Red Bull Ring,2001-05-13,1,0,11,10,22,10
2001,7,Monaco Grand Prix,monaco,Circuit de Monaco,2001-05-27,0,3,10,9,22,12
2001,8,Canadian Grand Prix,villeneuve,Circuit Gilles Villeneuve,2001-06-10,0,5,9,8,22,13
2001,9,European Grand Prix,nurburgring,Nürburgring,2001-06-24,0,2,14,6,22,8
2001,10,French Grand Prix,magny_cours,Circuit de Nevers Magny-Cours,2001-07-01,0,0,15,7,22,7
2001,11,British Grand Prix,silverstone,Silverstone Circuit,2001-07-15,0,2,16,3,21,5
2001,12,German Grand Prix,hockenheimring,Hockenheimring,2001-07-29,0,4,10,8,22,12
2001,13,Hungarian Grand Prix,hungaroring,Hungaroring,2001-08-19,0,5,12,5,22,10
2001,14,Belgian Grand Prix,spa,Circuit de Spa-Francorchamps,2001-09-02,0,5,13,4,22,9
2001,15,Italian Grand Prix,monza,Autodromo Nazionale di Monza,2001-09-16,0,2,13,7,22,9
2001,16,United States Grand Prix,indianapolis,Indianapolis Motor Speedway,2001-09-30,0,1,14,7,22,8
2001,17,Japanese Grand Prix,suzuka,Suzuka Circuit,2001-10-14,0,2,16,4,22,6
2002,1,Australian Grand Prix,albert_park,Albert Park Grand Prix Circuit,2002-03-03,2,9,8,3,22,12
2002,2,Malaysian Grand Prix,sepang,Sepang International Circuit,2002-03-17,0,0,13,9,22,9
2002,3,Brazilian Grand Prix,interlagos,Autódromo José Carlos Pace,2002-03-31,0,2,11,9,22,11
2002,4,San Marino Grand Prix,imola,Autodromo Enzo e Dino Ferrari,2002-04-14,0,0,11,10,21,10
2002,5,Spanish Grand Prix,catalunya,Circuit de Barcelona-Catalunya,2002-04-28,0,2,9,11,22,13
2002,6,Austrian Grand Prix,red_bull_ring,Red Bull Ring,2002-05-12,0,3,12,7,22,10
2002,7,Monaco Grand Prix,monaco,Circuit de Monaco,2002-05-26,0,7,12,3,22,10
2002,8,Canadian Grand Prix,villeneuve,Circuit Gilles Villeneuve,2002-06-09,0,1,13,8,22,9
2002,9,European Grand Prix,nurburgring,Nürburgring,2002-06-23,0,3,16,3,22,6
2002,10,British Grand Prix,silverstone,Silverstone Circuit,2002-07-07,0,1,11,9,21,10
2002,11,French Grand Prix,magny_cours,Circuit de Nevers Magny-Cours,2002-07-21,1,2,10,7,20,9
2002,12,German Grand Prix,hockenheimring,Hockenheimring,2002-07-28,0,2,9,10,21,12
2002,13,Hungarian Grand Prix,hungaroring,Hungaroring,2002-08-18,0,2,16,2,20,4
2002,14,Belgian Grand Prix,spa,Circuit de Spa-Francorchamps,2002-09-01,0,1,11,8,20,9
2002,15,Italian Grand Prix,monza,Autodromo Nazionale di Monza,2002-09-15,0,2,13,5,20,7
2002,16,United States Grand Prix,indianapolis,Indianapolis Motor Speedway,2002-09-29,0,0,16,4,20,4
2002,17,Japanese Grand Prix,suzuka,Suzuka Circuit,2002-10-13,1,2,10,7,20,9
2003,1,Australian Grand Prix,albert_park,Albert Park Grand Prix Circuit,2003-03-09,0,3,11,6,20,9
2003,2,Malaysian Grand Prix,sepang,Sepang International Circuit,2003-03-23,0,1,13,6,20,7
2003,3,Brazilian Grand Prix,interlagos,Autódromo José Carlos Pace,2003-04-06,0,8,9,3,20,11
2003,4,San Marino Grand Prix,imola,Autodromo Enzo e Dino Ferrari,2003-04-20,0,0,15,5,20,5
2003,5,Spanish Grand Prix,catalunya,Circuit de Barcelona-Catalunya,2003-05-04,0,3,12,5,20,8
2003,6,Austrian Grand Prix,red_bull_ring,Red Bull Ring,2003-05-18,0,0,13,7,20,7
2003,7,Monaco Grand Prix,monaco,Circuit de Monaco,2003-06-01,1,1,13,5,20,6
2003,8,Canadian Grand Prix,villeneuve,Circuit Gilles Villeneuve,2003-06-15,0,1,11,8,20,9
2003,9,European Grand Prix,nurburgring,Nürburgring,2003-06-29,0,1,15,4,20,5
2003,10,French Grand Prix,magny_cours,Circuit de Nevers Magny-Cours,2003-07-06,0,0,16,4,20,4
2003,11,British Grand Prix,silverstone,Silverstone Circuit,2003-07-20,0,0,17,3,20,3
2003,12,German Grand Prix,hockenheimring,Hockenheimring,2003-08-03,0,6,11,3,20,9
2003,13,Hungarian Grand Prix,hungaroring,Hungaroring,2003-08-24,0,0,13,7,20,7
2003,14,Italian Grand Prix,monza,Autodromo Nazionale di Monza,2003-09-14,0,0,13,7,20,7
2003,15,United States Grand Prix,indianapolis,Indianapolis Motor Speedway,2003-09-28,0,5,11,4,20,9
2003,16,Japanese Grand Prix,suzuka,Suzuka Circuit,2003-10-12,0,0,16,4,20,4
2004,1,Australian Grand Prix,albert_park,Albert Park Grand Prix Circuit,2004-03-07,1,0,14,5,20,5
2004,2,Malaysian Grand Prix,sepang,Sepang International Circuit,2004-03-21,0,1,16,3,20,4
2004,3,Bahrain Grand Prix,bahrain,Bahrain International Circuit,2004-04-04,0,0,17,3,20,3
2004,4,San Marino Grand Prix,imola,Autodromo Enzo e Dino Ferrari,2004-04-25,0,1,15,4,20,5
2004,5,Spanish Grand Prix,catalunya,Circuit de Barcelona-Catalunya,2004-05-09,0,2,13,5,20,7
2004,6,Monaco Grand Prix,monaco,Circuit de Monaco,2004-05-23,0,5,9,6,20,11
2004,7,European Grand Prix,nurburgring,Nürburgring,2004-05-30,0,2,15,3,20,5
2004,8,Canadian Grand Prix,villeneuve,Circuit Gilles Villeneuve,2004-06-13,4,1,10,5,20,6
2004,9,United States Grand Prix,indianapolis,Indianapolis Motor Speedway,2004-06-20,1,4,9,6,20,10
2004,10,French Grand Prix,magny_cours,Circuit de Nevers Magny-Cours,2004-07-04,0,1,18,1,20,2
2004,11,British Grand Prix,silverstone,Silverstone Circuit,2004-07-11,0,3,16,1,20,4
2004,12,German Grand Prix,hockenheimring,Hockenheimring,2004-07-25,0,1,17,2,20,3
2004,13,Hungarian Grand Prix,hungaroring,Hungaroring,2004-08-15,0,0,15,5,20,5
2004,14,Belgian Grand Prix,spa,Circuit de Spa-Francorchamps,2004-08-29,0,6,10,4,20,10
2004,15,Italian Grand Prix,monza,Autodromo Nazionale di Monza,2004-09-12,0,3,15,2,20,5
2004,16,Chinese Grand Prix,shanghai,Shanghai International Circuit,2004-09-26,0,2,16,2,20,4
2004,17,Japanese Grand Prix,suzuka,Suzuka Circuit,2004-10-10,0,3,16,1,20,4
2004,18,Brazilian Grand Prix,interlagos,Autódromo José Carlos Pace,2004-10-24,0,1,17,2,20,3
2005,1,Australian Grand Prix,albert_park,Albert Park Grand Prix Circuit,2005-03-06,0,2,17,1,20,3
2005,2,Malaysian Grand Prix,sepang,Sepang International Circuit,2005-03-20,0,4,13,3,20,7
2005,3,Bahrain Grand Prix,bahrain,Bahrain International Circuit,2005-04-03,0,0,12,8,20,8
2005,4,San Marino Grand Prix,imola,Autodromo Enzo e Dino Ferrari,2005-04-24,2,1,13,4,20,5
2005,5,Spanish Grand Prix,catalunya,Circuit de Barcelona-Catalunya,2005-05-08,0,3,12,3,18,6
2005,6,Monaco Grand Prix,monaco,Circuit de Monaco,2005-05-22,0,3,14,1,18,4
2005,7,European Grand Prix,nurburgring,Nürburgring,2005-05-29,0,3,17,0,20,3
2005,8,Canadian Grand Prix,villeneuve,Circuit Gilles Villeneuve,2005-06-12,1,1,11,7,20,8
2005,9,United States Grand Prix,indianapolis,Indianapolis Motor Speedway,2005-06-19,14,0,6,0,20,0
2005,10,French Grand Prix,magny_cours,Circuit de Nevers Magny-Cours,2005-07-03,0,2,15,3,20,5
2005,11,British Grand Prix,silverstone,Silverstone Circuit,2005-07-10,0,0,19,1,20,1
2005,12,German Grand Prix,hockenheimring,Hockenheimring,2005-07-24,0,0,19,1,20,1
2005,13,Hungarian Grand Prix,hungaroring,Hungaroring,2005-07-31,0,2,15,3,20,5
2005,14,Turkish Grand Prix,istanbul,Istanbul Park,2005-08-21,0,1,15,4,20,5
2005,15,Italian Grand Prix,monza,Autodromo Nazionale di Monza,2005-09-04,0,0,20,0,20,0
2005,16,Belgian Grand Prix,spa,Circuit de Spa-Francorchamps,2005-09-11,0,6,13,1,20,7
2005,17,Brazilian Grand Prix,interlagos,Autódromo José Carlos Pace,2005-09-25,0,2,16,2,20,4
2005,18,Japanese Grand Prix,suzuka,Suzuka Circuit,2005-10-09,1,3,16,0,20,3
2005,19,Chinese Grand Prix,shanghai,Shanghai International Circuit,2005-10-16,0,3,13,4,20,7
2006,1,Bahrain Grand Prix,bahrain,Bahrain International Circuit,2006-03-12,0,0,18,4,22,4
2006,2,Malaysian Grand Prix,sepang,Sepang International Circuit,2006-03-19,0,1,14,7,22,8
2006,3,Australian Grand Prix,albert_park,Albert Park Grand Prix Circuit,2006-04-02,0,6,13,3,22,9
2006,4,San Marino Grand Prix,imola,Autodromo Enzo e Dino Ferrari,2006-04-23,0,2,16,4,22,6
2006,5,European Grand Prix,nurburgring,Nürburgring,2006-05-07,0,2,13,7,22,9
2006,6,Spanish Grand Prix,catalunya,Circuit de Barcelona-Catalunya,2006-05-14,0,1,16,5,22,6
2006,7,Monaco Grand Prix,monaco,Circuit de Monaco,2006-05-28,0,1,16,5,22,6
2006,8,British Grand Prix,silverstone,Silverstone Circuit,2006-06-11,0,3,18,1,22,4
2006,9,Canadian Grand Prix,villeneuve,Circuit Gilles Villeneuve,2006-06-25,0,6,14,2,22,8
2006,10,United States Grand Prix,indianapolis,Indianapolis Motor Speedway,2006-07-02,0,10,10,2,22,12
2006,11,French Grand Prix,magny_cours,Circuit de Nevers Magny-Cours,2006-07-16,0,0,16,6,22,6
2006,12,German Grand Prix,hockenheimring,Hockenheimring,2006-07-30,2,2,12,6,22,8
2006,13,Hungarian Grand Prix,hungaroring,Hungaroring,2006-08-06,1,5,11,5,22,10
2006,14,Turkish Grand Prix,istanbul,Istanbul Park,2006-08-27,0,5,15,2,22,7
2006,15,Italian Grand Prix,monza,Autodromo Nazionale di Monza,2006-09-10,0,0,17,5,22,5
2006,16,Chinese Grand Prix,shanghai,Shanghai International Circuit,2006-10-01,1,2,16,3,22,5
2006,17,Japanese Grand Prix,suzuka,Suzuka Circuit,2006-10-08,0,1,17,4,22,5
2006,18,Brazilian Grand Prix,interlagos,Autódromo José Carlos Pace,2006-10-22,0,3,16,3,22,6
2007,1,Australian Grand Prix,albert_park,Albert Park Grand Prix Circuit,2007-03-18,0,4,17,1,22,5
2007,2,Malaysian Grand Prix,sepang,Sepang International Circuit,2007-04-08,0,1,18,3,22,4
2007,3,Bahrain Grand Prix,bahrain,Bahrain International Circuit,2007-04-15,0,2,15,5,22,7
2007,4,Spanish Grand Prix,catalunya,Circuit de Barcelona-Catalunya,2007-05-13,0,1,14,7,22,8
2007,5,Monaco Grand Prix,monaco,Circuit de Monaco,2007-05-27,0,2,17,3,22,5
2007,6,Canadian Grand Prix,villeneuve,Circuit Gilles Villeneuve,2007-06-10,2,6,12,2,22,8
2007,7,United States Grand Prix,indianapolis,Indianapolis Motor Speedway,2007-06-17,0,4,15,3,22,7
2007,8,French Grand Prix,magny_cours,Circuit de Nevers Magny-Cours,2007-07-01,0,3,17,2,22,5
2007,9,British Grand Prix,silverstone,Silverstone Circuit,2007-07-08,0,2,15,5,22,7
2007,10,European Grand Prix,nurburgring,Nürburgring,2007-07-22,0,6,13,3,22,9
2007,11,Hungarian Grand Prix,hungaroring,Hungaroring,2007-08-05,0,2,18,2,22,4
2007,12,Turkish Grand Prix,istanbul,Istanbul Park,2007-08-26,0,0,20,2,22,2
2007,13,Italian Grand Prix,monza,Autodromo Nazionale di Monza,2007-09-09,0,1,20,1,22,2
2007,14,Belgian Grand Prix,spa,Circuit de Spa-Francorchamps,2007-09-16,0,0,17,5,22,5
2007,15,Japanese Grand Prix,fuji,Fuji Speedway,2007-09-30,0,6,12,4,22,10
2007,16,Chinese Grand Prix,shanghai,Shanghai International Circuit,2007-10-07,0,3,17,2,22,5
2007,17,Brazilian Grand Prix,interlagos,Autódromo José Carlos Pace,2007-10-21,0,3,14,5,22,8
2008,1,Australian Grand Prix,albert_park,Albert Park Grand Prix Circuit,2008-03-16,1,8,6,7,22,15
2008,2,Malaysian Grand Prix,sepang,Sepang International Circuit,2008-03-23,0,3,17,2,22,5
2008,3,Bahrain Grand Prix,bahrain,Bahrain International Circuit,2008-04-06,0,1,19,2,22,3
2008,4,Spanish Grand Prix,catalunya,Circuit de Barcelona-Catalunya,2008-04-27,0,6,13,3,22,9
2008,5,Turkish Grand Prix,istanbul,Istanbul Park,2008-05-11,0,2,17,1,20,3
2008,6,Monaco Grand Prix,monaco,Circuit de Monaco,2008-05-25,0,5,14,1,20,6
2008,7,Canadian Grand Prix,villeneuve,Circuit Gilles Villeneuve,2008-06-08,0,5,13,2,20,7
2008,8,French Grand Prix,magny_cours,Circuit de Nevers Magny-Cours,2008-06-22,0,1,19,0,20,1
2008,9,British Grand Prix,silverstone,Silverstone Circuit,2008-07-06,0,7,13,0,20,7
2008,10,German Grand Prix,hockenheimring,Hockenheimring,2008-07-20,0,1,17,2,20,3
2008,11,Hungarian Grand Prix,hungaroring,Hungaroring,2008-08-03,0,0,17,3,20,3
2008,12,European Grand Prix,valencia,Valencia Street Circuit,2008-08-24,0,2,17,1,20,3
2008,13,Belgian Grand Prix,spa,Circuit de Spa-Francorchamps,2008-09-07,0,2,16,2,20,4
2008,14,Italian Grand Prix,monza,Autodromo Nazionale di Monza,2008-09-14,0,1,19,0,20,1
2008,15,Singapore Grand Prix,marina_bay,Marina Bay Street Circuit,2008-09-28,0,3,14,3,20,6
2008,16,Japanese Grand Prix,fuji,Fuji Speedway,2008-10-12,0,1,15,4,20,5
2008,17,Chinese Grand Prix,shanghai,Shanghai International Circuit,2008-10-19,0,1,17,2,20,3
2008,18,Brazilian Grand Prix,interlagos,Autódromo José Carlos Pace,2008-11-02,0,2,18,0,20,2
2009,1,Australian Grand Prix,albert_park,Albert Park Grand Prix Circuit,2009-03-29,1,5,12,2,20,7
2009,2,Malaysian Grand Prix,sepang,Sepang International Circuit,2009-04-05,0,4,15,1,20,5
2009,3,Chinese Grand Prix,shanghai,Shanghai International Circuit,2009-04-19,0,3,16,1,20,4
2009,4,Bahrain Grand Prix,bahrain,Bahrain International Circuit,2009-04-26,0,0,19,1,20,1
2009,5,Spanish Grand Prix,catalunya,Circuit de Barcelona-Catalunya,2009-05-10,0,4,14,2,20,6
2009,6,Monaco Grand Prix,monaco,Circuit de Monaco,2009-05-24,0,5,14,1,20,6
2009,7,Turkish Grand Prix,istanbul,Istanbul Park,2009-06-07,0,0,18,2,20,2
2009,8,British Grand Prix,silverstone,Silverstone Circuit,2009-06-21,0,2,18,0,20,2
2009,9,German Grand Prix,nurburgring,Nürburgring,2009-07-12,0,0,18,2,20,2
2009,10,Hungarian Grand Prix,hungaroring,Hungaroring,2009-07-26,1,0,16,3,20,3
2009,11,European Grand Prix,valencia,Valencia Street Circuit,2009-08-23,0,0,18,2,20,2
2009,12,Belgian Grand Prix,spa,Circuit de Spa-Francorchamps,2009-08-30,0,4,14,2,20,6
2009,13,Italian Grand Prix,monza,Autodromo Nazionale di Monza,2009-09-13,0,3,15,2,20,5
2009,14,Singapore Grand Prix,marina_bay,Marina Bay Street Circuit,2009-09-27,0,2,14,4,20,6
2009,15,Japanese Grand Prix,suzuka,Suzuka Circuit,2009-10-04,1,1,17,1,20,2
2009,16,Brazilian Grand Prix,interlagos,Autódromo José Carlos Pace,2009-10-18,0,4,14,2,20,6
2009,17,Abu Dhabi Grand Prix,yas_marina,Yas Marina Circuit,2009-11-01,0,0,18,2,20,2
2010,1,Bahrain Grand Prix,bahrain,Bahrain International Circuit,2010-03-14,0,1,15,8,24,9
2010,2,Australian Grand Prix,albert_park,Albert Park Grand Prix Circuit,2010-03-28,0,4,14,6,24,10
2010,3,Malaysian Grand Prix,sepang,Sepang International Circuit,2010-04-04,0,1,17,6,24,7
2010,4,Chinese Grand Prix,shanghai,Shanghai International Circuit,2010-04-18,0,3,17,4,24,7
2010,5,Spanish Grand Prix,catalunya,Circuit de Barcelona-Catalunya,2010-05-09,0,3,17,4,24,7
2010,6,Monaco Grand Prix,monaco,Circuit de Monaco,2010-05-16,0,3,12,9,24,12
2010,7,Turkish Grand Prix,istanbul,Istanbul Park,2010-05-30,0,1,19,4,24,5
2010,8,Canadian Grand Prix,villeneuve,Circuit Gilles Villeneuve,2010-06-13,0,1,19,4,24,5
2010,9,European Grand Prix,valencia,Valencia Street Circuit,2010-06-27,0,2,21,1,24,3
2010,10,British Grand Prix,silverstone,Silverstone Circuit,2010-07-11,0,1,20,3,24,4
2010,11,German Grand Prix,hockenheimring,Hockenheimring,2010-07-25,0,2,19,3,24,5
2010,12,Hungarian Grand Prix,hungaroring,Hungaroring,2010-08-01,0,1,19,4,24,5
2010,13,Belgian Grand Prix,spa,Circuit de Spa-Francorchamps,2010-08-29,0,4,20,0,24,4
2010,14,Italian Grand Prix,monza,Autodromo Nazionale di Monza,2010-09-12,0,1,20,3,24,4
2010,15,Singapore Grand Prix,marina_bay,Marina Bay Street Circuit,2010-09-26,0,5,15,4,24,9
2010,16,Japanese Grand Prix,suzuka,Suzuka Circuit,2010-10-10,0,4,16,4,24,8
2010,17,Korean Grand Prix,yeongam,Korean International Circuit,2010-10-24,0,7,15,2,24,9
2010,18,Brazilian Grand Prix,interlagos,Autódromo José Carlos Pace,2010-11-07,0,1,23,0,24,1
2010,19,Abu Dhabi Grand Prix,yas_marina,Yas Marina Circuit,2010-11-14,0,2,20,2,24,4
2011,1,Australian Grand Prix,albert_park,Albert Park Grand Prix Circuit,2011-03-27,2,2,15,3,22,5
2011,2,Malaysian Grand Prix,sepang,Sepang International Circuit,2011-04-10,0,3,18,3,24,6
2011,3,Chinese Grand Prix,shanghai,Shanghai International Circuit,2011-04-17,0,0,23,1,24,1
2011,4,Turkish Grand Prix,istanbul,Istanbul Park,2011-05-08,0,1,22,1,24,2
2011,5,Spanish Grand Prix,catalunya,Circuit de Barcelona-Catalunya,2011-05-22,0,1,21,2,24,3
2011,6,Monaco Grand Prix,monaco,Circuit de Monaco,2011-05-29,1,4,17,2,24,6
2011,7,Canadian Grand Prix,villeneuve,Circuit Gilles Villeneuve,2011-06-12,0,5,17,2,24,7
2011,8,European Grand Prix,valencia,Valencia Street Circuit,2011-06-26,0,0,24,0,24,0
2011,9,British Grand Prix,silverstone,Silverstone Circuit,2011-07-10,0,1,19,4,24,5
2011,10,German Grand Prix,nurburgring,Nürburgring,2011-07-24,0,1,20,3,24,4
2011,11,Hungarian Grand Prix,hungaroring,Hungaroring,2011-07-31,0,0,20,4,24,4
2011,12,Belgian Grand Prix,spa,Circuit de Spa-Francorchamps,2011-08-28,0,2,19,3,24,5
2011,13,Italian Grand Prix,monza,Autodromo Nazionale di Monza,2011-09-11,0,4,16,4,24,8
2011,14,Singapore Grand Prix,marina_bay,Marina Bay Street Circuit,2011-09-25,0,3,20,1,24,4
2011,15,Japanese Grand Prix,suzuka,Suzuka Circuit,2011-10-09,0,0,23,1,24,1
2011,16,Korean Grand Prix,yeongam,Korean International Circuit,2011-10-16,0,2,21,1,24,3
2011,17,Indian Grand Prix,buddh,Buddh International Circuit,2011-10-30,0,2,19,3,24,5
2011,18,Abu Dhabi Grand Prix,yas_marina,Yas Marina Circuit,2011-11-13,0,1,20,3,24,4
2011,19,Brazilian Grand Prix,interlagos,Autódromo José Carlos Pace,2011-11-27,0,2,20,2,24,4
2012,1,Australian Grand Prix,albert_park,Albert Park Grand Prix Circuit,2012-03-18,0,5,14,3,22,8
2012,2,Malaysian Grand Prix,sepang,Sepang International Circuit,2012-03-25,0,1,21,2,24,3
2012,3,Chinese Grand Prix,shanghai,Shanghai International Circuit,2012-04-15,0,0,23,1,24,1
2012,4,Bahrain Grand Prix,bahrain,Bahrain International Circuit,2012-04-22,0,1,20,3,24,4
2012,5,Spanish Grand Prix,catalunya,Circuit de Barcelona-Catalunya,2012-05-13,0,2,19,3,24,5
2012,6,Monaco Grand Prix,monaco,Circuit de Monaco,2012-05-27,0,6,15,3,24,9
2012,7,Canadian Grand Prix,villeneuve,Circuit Gilles Villeneuve,2012-06-10,0,0,20,4,24,4
2012,8,European Grand Prix,valencia,Valencia Street Circuit,2012-06-24,1,3,18,2,24,5
2012,9,British Grand Prix,silverstone,Silverstone Circuit,2012-07-08,0,2,21,1,24,3
2012,10,German Grand Prix,hockenheimring,Hockenheimring,2012-07-22,0,1,23,0,24,1
2012,11,Hungarian Grand Prix,hungaroring,Hungaroring,2012-07-29,0,0,23,1,24,1
2012,12,Belgian Grand Prix,spa,Circuit de Spa-Francorchamps,2012-09-02,0,6,18,0,24,6
2012,13,Italian Grand Prix,monza,Autodromo Nazionale di Monza,2012-09-09,0,0,19,5,24,5
2012,14,Singapore Grand Prix,marina_bay,Marina Bay Street Circuit,2012-09-23,0,4,18,2,24,6
2012,15,Japanese Grand Prix,suzuka,Suzuka Circuit,2012-10-07,0,3,19,2,24,5
2012,16,Korean Grand Prix,yeongam,Korean International Circuit,2012-10-14,0,3,20,1,24,4
2012,17,Indian Grand Prix,buddh,Buddh International Circuit,2012-10-28,0,2,21,1,24,3
2012,18,Abu Dhabi Grand Prix,yas_marina,Yas Marina Circuit,2012-11-04,0,6,17,1,24,7
2012,19,United States Grand Prix,americas,Circuit of the Americas,2012-11-18,0,0,22,2,24,2
2012,20,Brazilian Grand Prix,interlagos,Autódromo José Carlos Pace,2012-11-25,0,6,18,0,24,6
2013,1,Australian Grand Prix,albert_park,Albert Park Grand Prix Circuit,2013-03-17,0,1,18,3,22,4
2013,2,Malaysian Grand Prix,sepang,Sepang International Circuit,2013-03-24,1,2,16,3,22,5
2013,3,Chinese Grand Prix,shanghai,Shanghai International Circuit,2013-04-14,0,2,18,2,22,4
2013,4,Bahrain Grand Prix,bahrain,Bahrain International Circuit,2013-04-21,0,1,21,0,22,1
2013,5,Spanish Grand Prix,catalunya,Circuit de Barcelona-Catalunya,2013-05-12,0,1,19,2,22,3
2013,6,Monaco Grand Prix,monaco,Circuit de Monaco,2013-05-26,0,4,15,3,22,7
2013,7,Canadian Grand Prix,villeneuve,Circuit Gilles Villeneuve,2013-06-09,0,3,19,0,22,3
2013,8,British Grand Prix,silverstone,Silverstone Circuit,2013-06-30,0,0,18,4,22,4
2013,9,German Grand Prix,nurburgring,Nürburgring,2013-07-07,0,1,19,2,22,3
2013,10,Hungarian Grand Prix,hungaroring,Hungaroring,2013-07-28,0,0,17,5,22,5
2013,11,Belgian Grand Prix,spa,Circuit de Spa-Francorchamps,2013-08-25,0,1,19,2,22,3
2013,12,Italian Grand Prix,monza,Autodromo Nazionale di Monza,2013-09-08,0,1,20,1,22,2
2013,13,Singapore Grand Prix,marina_bay,Marina Bay Street Circuit,2013-09-22,0,2,18,2,22,4
2013,14,Korean Grand Prix,yeongam,Korean International Circuit,2013-10-06,0,3,19,0,22,3
2013,15,Japanese Grand Prix,suzuka,Suzuka Circuit,2013-10-13,0,3,19,0,22,3
2013,16,Indian Grand Prix,buddh,Buddh International Circuit,2013-10-27,0,1,18,3,22,4
2013,17,Abu Dhabi Grand Prix,yas_marina,Yas Marina Circuit,2013-11-03,0,1,21,0,22,1
2013,18,United States Grand Prix,americas,Circuit of the Americas,2013-11-17,0,1,21,0,22,1
2013,19,Brazilian Grand Prix,interlagos,Autódromo José Carlos Pace,2013-11-24,0,1,19,2,22,3
2014,1,Australian Grand Prix,albert_park,Albert Park Grand Prix Circuit,2014-03-16,1,2,14,5,22,7
2014,2,Malaysian Grand Prix,sepang,Sepang International Circuit,2014-03-30,1,0,15,6,22,6
2014,3,Bahrain Grand Prix,bahrain,Bahrain International Circuit,2014-04-06,0,3,16,3,22,6
2014,4,Chinese Grand Prix,shanghai,Shanghai International Circuit,2014-04-20,0,0,20,2,22,2
2014,5,Spanish Grand Prix,catalunya,Circuit de Barcelona-Catalunya,2014-05-11,0,0,20,2,22,2
2014,6,Monaco Grand Prix,monaco,Circuit de Monaco,2014-05-25,1,3,14,4,22,7
2014,7,Canadian Grand Prix,villeneuve,Circuit Gilles Villeneuve,2014-06-08,0,4,11,7,22,11
2014,8,Austrian Grand Prix,red_bull_ring,Red Bull Ring,2014-06-22,0,0,19,3,22,3
2014,9,British Grand Prix,silverstone,Silverstone Circuit,2014-07-06,0,3,17,2,22,5
2014,10,German Grand Prix,hockenheimring,Hockenheimring,2014-07-20,0,1,18,3,22,4
2014,11,Hungarian Grand Prix,hungaroring,Hungaroring,2014-07-27,0,5,16,1,22,6
2014,12,Belgian Grand Prix,spa,Circuit de Spa-Francorchamps,2014-08-24,0,1,17,4,22,5
2014,13,Italian Grand Prix,monza,Autodromo Nazionale di Monza,2014-09-07,0,1,20,1,22,2
2014,14,Singapore Grand Prix,marina_bay,Marina Bay Street Circuit,2014-09-21,0,1,17,4,22,5
2014,15,Japanese Grand Prix,suzuka,Suzuka Circuit,2014-10-05,0,2,19,1,22,3
2014,16,Russian Grand Prix,sochi,Sochi Autodrom,2014-10-12,0,0,19,2,21,2
2014,17,United States Grand Prix,americas,Circuit of the Americas,2014-11-02,0,2,15,1,18,3
2014,18,Brazilian Grand Prix,interlagos,Autódromo José Carlos Pace,2014-11-09,0,0,17,1,18,1
2014,19,Abu Dhabi Grand Prix,yas_marina,Yas Marina Circuit,2014-11-23,0,0,17,3,20,3
2015,1,Australian Grand Prix,albert_park,Albert Park Grand Prix Circuit,2015-03-15,3,1,11,3,18,4
2015,2,Malaysian Grand Prix,sepang,Sepang International Circuit,2015-03-29,0,2,15,3,20,5
2015,3,Chinese Grand Prix,shanghai,Shanghai International Circuit,2015-04-12,0,0,16,4,20,4
2015,4,Bahrain Grand Prix,bahrain,Bahrain International Circuit,2015-04-19,0,0,17,3,20,3
2015,5,Spanish Grand Prix,catalunya,Circuit de Barcelona-Catalunya,2015-05-10,0,1,18,1,20,2
2015,6,Monaco Grand Prix,monaco,Circuit de Monaco,2015-05-24,0,1,17,2,20,3
2015,7,Canadian Grand Prix,villeneuve,Circuit Gilles Villeneuve,2015-06-07,0,1,17,2,20,3
2015,8,Austrian Grand Prix,red_bull_ring,Red Bull Ring,2015-06-21,0,2,14,4,20,6
2015,9,British Grand Prix,silverstone,Silverstone Circuit,2015-07-05,0,4,13,3,20,7
2015,10,Hungarian Grand Prix,hungaroring,Hungaroring,2015-07-26,0,1,16,3,20,4
2015,11,Belgian Grand Prix,spa,Circuit de Spa-Francorchamps,2015-08-23,0,0,14,6,20,6
2015,12,Italian Grand Prix,monza,Autodromo Nazionale di Monza,2015-09-06,0,2,18,0,20,2
2015,13,Singapore Grand Prix,marina_bay,Marina Bay Street Circuit,2015-09-20,0,1,14,5,20,6
2015,14,Japanese Grand Prix,suzuka,Suzuka Circuit,2015-09-27,0,1,19,0,20,1
2015,15,Russian Grand Prix,sochi,Sochi Autodrom,2015-10-11,0,4,13,3,20,7
2015,16,United States Grand Prix,americas,Circuit of the Americas,2015-10-25,0,4,12,4,20,8
2015,17,Mexican Grand Prix,rodriguez,Autódromo Hermanos Rodríguez,2015-11-01,0,3,16,1,20,4
2015,18,Brazilian Grand Prix,interlagos,Autódromo José Carlos Pace,2015-11-15,1,0,18,1,20,1
2015,19,Abu Dhabi Grand Prix,yas_marina,Yas Marina Circuit,2015-11-29,0,1,19,0,20,1
2016,1,Australian Grand Prix,albert_park,Albert Park Grand Prix Circuit,2016-03-20,0,3,16,3,22,6
2016,2,Bahrain Grand Prix,bahrain,Bahrain International Circuit,2016-04-03,0,1,17,4,22,5
2016,3,Chinese Grand Prix,shanghai,Shanghai International Circuit,2016-04-17,0,0,22,0,22,0
2016,4,Russian Grand Prix,sochi,Sochi Autodrom,2016-05-01,0,3,18,1,22,4
2016,5,Spanish Grand Prix,catalunya,Circuit de Barcelona-Catalunya,2016-05-15,0,2,17,3,22,5
2016,6,Monaco Grand Prix,monaco,Circuit de Monaco,2016-05-29,0,6,15,1,22,7
2016,7,Canadian Grand Prix,villeneuve,Circuit Gilles Villeneuve,2016-06-12,0,1,19,2,22,3
2016,8,European Grand Prix,baku,Baku City Circuit,2016-06-19,0,0,18,4,22,4
2016,9,Austrian Grand Prix,red_bull_ring,Red Bull Ring,2016-07-03,0,0,16,6,22,6
2016,10,British Grand Prix,silverstone,Silverstone Circuit,2016-07-10,0,3,16,3,22,6
2016,11,Hungarian Grand Prix,hungaroring,Hungaroring,2016-07-24,0,0,21,1,22,1
2016,12,German Grand Prix,hockenheimring,Hockenheimring,2016-07-31,0,0,20,2,22,2
2016,13,Belgian Grand Prix,spa,Circuit de Spa-Francorchamps,2016-08-28,0,4,17,1,22,5
2016,14,Italian Grand Prix,monza,Autodromo Nazionale di Monza,2016-09-04,0,2,18,2,22,4
2016,15,Singapore Grand Prix,marina_bay,Marina Bay Street Circuit,2016-09-18,1,1,18,2,22,3
2016,16,Malaysian Grand Prix,sepang,Sepang International Circuit,2016-10-02,0,1,16,5,22,6
2016,17,Japanese Grand Prix,suzuka,Suzuka Circuit,2016-10-09,0,0,22,0,22,0
2016,18,United States Grand Prix,americas,Circuit of the Americas,2016-10-23,0,1,18,3,22,4
2016,19,Mexican Grand Prix,rodriguez,Autódromo Hermanos Rodríguez,2016-10-30,0,1,21,0,22,1
2016,20,Brazilian Grand Prix,interlagos,Autódromo José Carlos Pace,2016-11-13,1,4,16,1,22,5
2016,21,Abu Dhabi Grand Prix,yas_marina,Yas Marina Circuit,2016-11-27,0,1,17,4,22,5
2017,1,Australian Grand Prix,albert_park,Albert Park Grand Prix Circuit,2017-03-26,0,0,13,7,20,7
2017,2,Chinese Grand Prix,shanghai,Shanghai International Circuit,2017-04-09,0,2,15,3,20,5
2017,3,Bahrain Grand Prix,bahrain,Bahrain International Circuit,2017-04-16,0,2,13,5,20,7
2017,4,Russian Grand Prix,sochi,Sochi Autodrom,2017-04-30,0,2,16,2,20,4
2017,5,Spanish Grand Prix,catalunya,Circuit de Barcelona-Catalunya,2017-05-14,0,3,16,1,20,4
2017,6,Monaco Grand Prix,monaco,Circuit de Monaco,2017-05-28,0,5,13,2,20,7
2017,7,Canadian Grand Prix,villeneuve,Circuit Gilles Villeneuve,2017-06-11,0,2,15,3,20,5
2017,8,Azerbaijan Grand Prix,baku,Baku City Circuit,2017-06-25,0,1,13,6,20,7
2017,9,Austrian Grand Prix,red_bull_ring,Red Bull Ring,2017-07-09,0,2,16,2,20,4
2017,10,British Grand Prix,silverstone,Silverstone Circuit,2017-07-16,0,1,17,2,20,3
2017,11,Hungarian Grand Prix,hungaroring,Hungaroring,2017-07-30,0,1,16,3,20,4
2017,12,Belgian Grand Prix,spa,Circuit de Spa-Francorchamps,2017-08-27,0,1,16,3,20,4
2017,13,Italian Grand Prix,monza,Autodromo Nazionale di Monza,2017-09-03,0,0,16,4,20,4
2017,14,Singapore Grand Prix,marina_bay,Marina Bay Street Circuit,2017-09-17,0,6,12,2,20,8
2017,15,Malaysian Grand Prix,sepang,Sepang International Circuit,2017-10-01,0,0,18,2,20,2
2017,16,Japanese Grand Prix,suzuka,Suzuka Circuit,2017-10-08,0,3,15,2,20,5
2017,17,United States Grand Prix,americas,Circuit of the Americas,2017-10-22,0,1,16,3,20,4
2017,18,Mexican Grand Prix,rodriguez,Autódromo Hermanos Rodríguez,2017-10-29,0,0,15,5,20,5
2017,19,Brazilian Grand Prix,interlagos,Autódromo José Carlos Pace,2017-11-12,0,3,16,1,20,4
2017,20,Abu Dhabi Grand Prix,yas_marina,Yas Marina Circuit,2017-11-26,0,0,18,2,20,2
2018,1,Australian Grand Prix,albert_park,Albert Park Grand Prix Circuit,2018-03-25,0,0,15,5,20,5
2018,2,Bahrain Grand Prix,bahrain,Bahrain International Circuit,2018-04-08,0,1,17,2,20,3
2018,3,Chinese Grand Prix,shanghai,Shanghai International Circuit,2018-04-15,0,1,19,0,20,1
2018,4,Azerbaijan Grand Prix,baku,Baku City Circuit,2018-04-29,0,7,13,0,20,7
2018,5,Spanish Grand Prix,catalunya,Circuit de Barcelona-Catalunya,2018-05-13,0,3,14,3,20,6
2018,6,Monaco Grand Prix,monaco,Circuit de Monaco,2018-05-27,0,2,17,1,20,3
2018,7,Canadian Grand Prix,villeneuve,Circuit Gilles Villeneuve,2018-06-10,0,2,17,1,20,3
2018,8,French Grand Prix,ricard,Circuit Paul Ricard,2018-06-24,0,3,15,2,20,5
2018,9,Austrian Grand Prix,red_bull_ring,Red Bull Ring,2018-07-01,0,1,14,5,20,6
2018,10,British Grand Prix,silverstone,Silverstone Circuit,2018-07-08,0,3,14,3,20,6
2018,11,German Grand Prix,hockenheimring,Hockenheimring,2018-07-22,0,2,15,3,20,5
2018,12,Hungarian Grand Prix,hungaroring,Hungaroring,2018-07-29,0,0,17,3,20,3
2018,13,Belgian Grand Prix,spa,Circuit de Spa-Francorchamps,2018-08-26,0,3,15,2,20,5
2018,14,Italian Grand Prix,monza,Autodromo Nazionale di Monza,2018-09-02,1,0,16,3,20,3
2018,15,Singapore Grand Prix,marina_bay,Marina Bay Street Circuit,2018-09-16,0,1,19,0,20,1
2018,16,Russian Grand Prix,sochi,Sochi Autodrom,2018-09-30,0,0,18,2,20,2
2018,17,Japanese Grand Prix,suzuka,Suzuka Circuit,2018-10-07,0,1,17,2,20,3
2018,18,United States Grand Prix,americas,Circuit of the Americas,2018-10-21,2,3,14,1,20,4
2018,19,Mexican Grand Prix,rodriguez,Autódromo Hermanos Rodríguez,2018-10-28,0,0,16,4,20,4
2018,20,Brazilian Grand Prix,interlagos,Autódromo José Carlos Pace,2018-11-11,0,1,18,1,20,2
2018,21,Abu Dhabi Grand Prix,yas_marina,Yas Marina Circuit,2018-11-25,0,1,15,4,20,5
2019,1,Australian Grand Prix,albert_park,Albert Park Grand Prix Circuit,2019-03-17,0,1,17,2,20,3
2019,2,Bahrain Grand Prix,bahrain,Bahrain International Circuit,2019-03-31,0,2,16,2,20,4
2019,3,Chinese Grand Prix,shanghai,Shanghai International Circuit,2019-04-14,0,2,17,1,20,3
2019,4,Azerbaijan Grand Prix,baku,Baku City Circuit,2019-04-28,0,2,16,2,20,4
2019,5,Spanish Grand Prix,catalunya,Circuit de Barcelona-Catalunya,2019-05-12,0,2,18,0,20,2
2019,6,Monaco Grand Prix,monaco,Circuit de Monaco,2019-05-26,0,1,19,0,20,1
2019,7,Canadian Grand Prix,villeneuve,Circuit Gilles Villeneuve,2019-06-09,0,1,18,1,20,2
2019,8,French Grand Prix,ricard,Circuit Paul Ricard,2019-06-23,0,0,19,1,20,1
2019,9,Austrian Grand Prix,red_bull_ring,Red Bull Ring,2019-06-30,0,0,20,0,20,0
2019,10,British Grand Prix,silverstone,Silverstone Circuit,2019-07-14,0,3,17,0,20,3
2019,11,German Grand Prix,hockenheimring,Hockenheimring,2019-07-28,0,5,13,2,20,7
2019,12,Hungarian Grand Prix,hungaroring,Hungaroring,2019-08-04,0,0,19,1,20,1
2019,13,Belgian Grand Prix,spa,Circuit de Spa-Francorchamps,2019-09-01,0,2,16,2,20,4
2019,14,Italian Grand Prix,monza,Autodromo Nazionale di Monza,2019-09-08,0,0,17,3,20,3
2019,15,Singapore Grand Prix,marina_bay,Marina Bay Street Circuit,2019-09-22,0,2,17,1,20,3
2019,16,Russian Grand Prix,sochi,Sochi Autodrom,2019-09-29,0,2,15,3,20,5
2019,17,Japanese Grand Prix,suzuka,Suzuka Circuit,2019-10-13,2,0,17,1,20,1
2019,18,Mexican Grand Prix,rodriguez,Autódromo Hermanos Rodríguez,2019-10-27,1,0,18,1,20,1
2019,19,United States Grand Prix,americas,Circuit of the Americas,2019-11-03,0,0,16,4,20,4
2019,20,Brazilian Grand Prix,interlagos,Autódromo José Carlos Pace,2019-11-17,0,2,16,2,20,4
2019,21,Abu Dhabi Grand Prix,yas_marina,Yas Marina Circuit,2019-12-01,0,0,19,1,20,1
2020,1,Austrian Grand Prix,red_bull_ring,Red Bull Ring,2020-07-05,0,0,11,9,20,9
2020,2,Styrian Grand Prix,red_bull_ring,Red Bull Ring,2020-07-12,0,2,17,1,20,3
2020,3,Hungarian Grand Prix,hungaroring,Hungaroring,2020-07-19,0,0,19,1,20,1
2020,4,British Grand Prix,silverstone,Silverstone Circuit,2020-08-02,0,2,17,1,20,3
2020,5,70th Anniversary Grand Prix,silverstone,Silverstone Circuit,2020-08-09,0,1,19,0,20,1
2020,6,Spanish Grand Prix,catalunya,Circuit de Barcelona-Catalunya,2020-08-16,0,0,19,1,20,1
2020,7,Belgian Grand Prix,spa,Circuit de Spa-Francorchamps,2020-08-30,0,2,17,1,20,3
2020,8,Italian Grand Prix,monza,Autodromo Nazionale di Monza,2020-09-06,0,1,16,3,20,4
2020,9,Tuscan Grand Prix,mugello,Autodromo Internazionale del Mugello,2020-09-13,0,7,12,1,20,8
2020,10,Russian Grand Prix,sochi,Sochi Autodrom,2020-09-27,0,2,18,0,20,2
2020,11,Eifel Grand Prix,nurburgring,Nürburgring,2020-10-11,0,1,15,4,20,5
2020,12,Portuguese Grand Prix,portimao,Autódromo Internacional do Algarve,2020-10-25,0,1,19,0,20,1
2020,13,Emilia Romagna Grand Prix,imola,Autodromo Enzo e Dino Ferrari,2020-11-01,1,2,15,2,20,4
2020,14,Turkish Grand Prix,istanbul,Istanbul Park,2020-11-15,1,2,16,1,20,3
2020,15,Bahrain Grand Prix,bahrain,Bahrain International Circuit,2020-11-29,0,2,17,1,20,3
2020,16,Sakhir Grand Prix,bahrain,Bahrain International Circuit,2020-12-06,0,2,17,1,20,3
2020,17,Abu Dhabi Grand Prix,yas_marina,Yas Marina Circuit,2020-12-13,0,0,19,1,20,1
2021,1,Bahrain Grand Prix,bahrain,Bahrain International Circuit,2021-03-28,0,2,16,2,20,4
2021,2,Emilia Romagna Grand Prix,imola,Autodromo Enzo e Dino Ferrari,2021-04-18,0,3,16,1,20,4
2021,3,Portuguese Grand Prix,portimao,Autódromo Internacional do Algarve,2021-05-02,0,1,19,0,20,1
2021,4,Spanish Grand Prix,catalunya,Circuit de Barcelona-Catalunya,2021-05-09,0,0,19,1,20,1
2021,5,Monaco Grand Prix,monaco,Circuit de Monaco,2021-05-23,0,0,18,2,20,2
2021,6,Azerbaijan Grand Prix,baku,Baku City Circuit,2021-06-06,0,2,16,2,20,4
2021,7,French Grand Prix,ricard,Circuit Paul Ricard,2021-06-20,0,0,20,0,20,0
2021,8,Styrian Grand Prix,red_bull_ring,Red Bull Ring,2021-06-27,0,1,18,1,20,2
2021,9,Austrian Grand Prix,red_bull_ring,Red Bull Ring,2021-07-04,0,2,18,0,20,2
2021,10,British Grand Prix,silverstone,Silverstone Circuit,2021-07-18,0,1,18,1,20,2
2021,11,Hungarian Grand Prix,hungaroring,Hungaroring,2021-08-01,1,6,13,0,20,6
2021,12,Belgian Grand Prix,spa,Circuit de Spa-Francorchamps,2021-08-29,0,0,20,0,20,0
2021,13,Dutch Grand Prix,zandvoort,Circuit Park Zandvoort,2021-09-05,0,0,17,3,20,3
2021,14,Italian Grand Prix,monza,Autodromo Nazionale di Monza,2021-09-12,0,2,15,3,20,5
2021,15,Russian Grand Prix,sochi,Sochi Autodrom,2021-09-26,0,1,18,1,20,2
2021,16,Turkish Grand Prix,istanbul,Istanbul Park,2021-10-10,0,0,20,0,20,0
2021,17,United States Grand Prix,americas,Circuit of the Americas,2021-10-24,0,0,17,3,20,3
2021,18,Mexico City Grand Prix,rodriguez,Autódromo Hermanos Rodríguez,2021-11-07,0,2,18,0,20,2
2021,19,São Paulo Grand Prix,interlagos,Autódromo José Carlos Pace,2021-11-14,0,1,18,1,20,2
2021,20,Qatar Grand Prix,losail,Losail International Circuit,2021-11-21,0,2,18,0,20,2
2021,21,Saudi Arabian Grand Prix,jeddah,Jeddah Corniche Circuit,2021-12-05,0,5,15,0,20,5
2021,22,Abu Dhabi Grand Prix,yas_marina,Yas Marina Circuit,2021-12-12,1,1,14,4,20,5
2022,1,Bahrain Grand Prix,bahrain,Bahrain International Circuit,2022-03-20,0,0,17,3,20,3
2022,2,Saudi Arabian Grand Prix,jeddah,Jeddah Corniche Circuit,2022-03-27,1,2,13,4,20,6
2022,3,Australian Grand Prix,albert_park,Albert Park Grand Prix Circuit,2022-04-10,0,2,17,1,20,3
2022,4,Emilia Romagna Grand Prix,imola,Autodromo Enzo e Dino Ferrari,2022-04-24,0,2,18,0,20,2
2022,5,Miami Grand Prix,miami,Miami International Autodrome,2022-05-08,0,3,15,2,20,5
2022,6,Spanish Grand Prix,catalunya,Circuit de Barcelona-Catalunya,2022-05-22,0,0,18,2,20,2
2022,7,Monaco Grand Prix,monaco,Circuit de Monaco,2022-05-29,0,1,17,2,20,3
2022,8,Azerbaijan Grand Prix,baku,Baku City Circuit,2022-06-12,0,0,15,5,20,5
2022,9,Canadian Grand Prix,villeneuve,Circuit Gilles Villeneuve,2022-06-19,0,1,17,2,20,3
2022,10,British Grand Prix,silverstone,Silverstone Circuit,2022-07-03,0,4,14,2,20,6
2022,11,Austrian Grand Prix,red_bull_ring,Red Bull Ring,2022-07-10,0,1,17,2,20,3
2022,12,French Grand Prix,ricard,Circuit Paul Ricard,2022-07-24,0,3,16,1,20,4
2022,13,Hungarian Grand Prix,hungaroring,Hungaroring,2022-07-31,0,0,19,1,20,1
2022,14,Belgian Grand Prix,spa,Circuit de Spa-Francorchamps,2022-08-28,0,2,18,0,20,2
2022,15,Dutch Grand Prix,zandvoort,Circuit Park Zandvoort,2022-09-04,0,0,18,2,20,2
2022,16,Italian Grand Prix,monza,Autodromo Nazionale di Monza,2022-09-11,0,0,16,4,20,4
2022,17,Singapore Grand Prix,marina_bay,Marina Bay Street Circuit,2022-10-02,0,4,14,2,20,6
2022,18,Japanese Grand Prix,suzuka,Suzuka Circuit,2022-10-09,0,1,18,1,20,2
2022,19,United States Grand Prix,americas,Circuit of the Americas,2022-10-23,0,3,17,0,20,3
2022,20,Mexico City Grand Prix,rodriguez,Autódromo Hermanos Rodríguez,2022-10-30,0,1,18,1,20,2
2022,21,São Paulo Grand Prix,interlagos,Autódromo José Carlos Pace,2022-11-13,0,2,17,1,20,3
2022,22,Abu Dhabi Grand Prix,yas_marina,Yas Marina Circuit,2022-11-20,0,1,17,2,20,3
2023,1,Bahrain Grand Prix,bahrain,Bahrain International Circuit,2023-03-05,0,0,17,3,20,3
2023,2,Saudi Arabian Grand Prix,jeddah,Jeddah Corniche Circuit,2023-03-19,0,0,18,2,20,2
2023,3,Australian Grand Prix,albert_park,Albert Park Grand Prix Circuit,2023-04-02,0,7,12,1,20,8
2023,4,Azerbaijan Grand Prix,baku,Baku City Circuit,2023-04-30,0,1,18,1,20,2
2023,5,Miami Grand Prix,miami,Miami International Autodrome,2023-05-07,0,0,20,0,20,0
2023,6,Monaco Grand Prix,monaco,Circuit de Monaco,2023-05-28,0,2,18,0,20,2
2023,7,Spanish Grand Prix,catalunya,Circuit de Barcelona-Catalunya,2023-06-04,0,0,20,0,20,0
2023,8,Canadian Grand Prix,villeneuve,Circuit Gilles Villeneuve,2023-06-18,0,0,18,2,20,2
2023,9,Austrian Grand Prix,red_bull_ring,Red Bull Ring,2023-07-02,0,0,19,1,20,1
2023,10,British Grand Prix,silverstone,Silverstone Circuit,2023-07-09,0,1,17,2,20,3
2023,11,Hungarian Grand Prix,hungaroring,Hungaroring,2023-07-23,0,3,17,0,20,3
2023,12,Belgian Grand Prix,spa,Circuit de Spa-Francorchamps,2023-07-30,0,2,18,0,20,2
2023,13,Dutch Grand Prix,zandvoort,Circuit Park Zandvoort,2023-08-27,0,2,17,1,20,3
2023,14,Italian Grand Prix,monza,Autodromo Nazionale di Monza,2023-09-03,0,0,18,2,20,2
2023,15,Singapore Grand Prix,marina_bay,Marina Bay Street Circuit,2023-09-17,1,2,15,2,20,4
2023,16,Japanese Grand Prix,suzuka,Suzuka Circuit,2023-09-24,0,4,15,1,20,5
2023,17,Qatar Grand Prix,losail,Losail International Circuit,2023-10-08,1,1,17,1,20,2
2023,18,United States Grand Prix,americas,Circuit of the Americas,2023-10-22,2,1,15,2,20,3
2023,19,Mexico City Grand Prix,rodriguez,Autódromo Hermanos Rodríguez,2023-10-29,1,3,15,1,20,4
2023,20,São Paulo Grand Prix,interlagos,Autódromo José Carlos Pace,2023-11-05,0,2,14,4,20,6
2023,21,Las Vegas Grand Prix,vegas,Las Vegas Strip Street Circuit,2023-11-19,0,1,17,2,20,3
2023,22,Abu Dhabi Grand Prix,yas_marina,Yas Marina Circuit,2023-11-26,0,1,19,0,20,1
2024,1,Bahrain Grand Prix,bahrain,Bahrain International Circuit,2024-03-02,0,0,20,0,20,0
2024,2,Saudi Arabian Grand Prix,jeddah,Jeddah Corniche Circuit,2024-03-09,0,1,18,1,20,2
2024,3,Australian Grand Prix,albert_park,Albert Park Grand Prix Circuit,2024-03-24,0,1,16,2,19,3
2024,4,Japanese Grand Prix,suzuka,Suzuka Circuit,2024-04-07,0,2,17,1,20,3
2024,5,Chinese Grand Prix,shanghai,Shanghai International Circuit,2024-04-21,0,1,17,2,20,3
2024,6,Miami Grand Prix,miami,Miami International Autodrome,2024-05-05,0,1,19,0,20,1
2024,7,Emilia Romagna Grand Prix,imola,Autodromo Enzo e Dino Ferrari,2024-05-19,0,1,19,0,20,1
2024,8,Monaco Grand Prix,monaco,Circuit de Monaco,2024-05-26,0,4,16,0,20,4
2024,9,Canadian Grand Prix,villeneuve,Circuit Gilles Villeneuve,2024-06-09,0,4,15,1,20,5
2024,10,Spanish Grand Prix,catalunya,Circuit de Barcelona-Catalunya,2024-06-23,0,0,20,0,20,0
2024,11,Austrian Grand Prix,red_bull_ring,Red Bull Ring,2024-06-30,0,0,20,0,20,0
2024,12,British Grand Prix,silverstone,Silverstone Circuit,2024-07-07,0,0,18,2,20,2
2024,13,Hungarian Grand Prix,hungaroring,Hungaroring,2024-07-21,0,0,19,1,20,1
2024,14,Belgian Grand Prix,spa,Circuit de Spa-Francorchamps,2024-07-28,1,0,18,1,20,1
2024,15,Dutch Grand Prix,zandvoort,Circuit Park Zandvoort,2024-08-25,0,0,20,0,20,0
2024,16,Italian Grand Prix,monza,Autodromo Nazionale di Monza,2024-09-01,0,0,19,1,20,1
2024,17,Azerbaijan Grand Prix,baku,Baku City Circuit,2024-09-15,0,2,16,2,20,4
2024,18,Singapore Grand Prix,marina_bay,Marina Bay Street Circuit,2024-09-22,0,1,18,1,20,2
2024,19,United States Grand Prix,americas,Circuit of the Americas,2024-10-20,0,1,19,0,20,1
2024,20,Mexico City Grand Prix,rodriguez,Autódromo Hermanos Rodríguez,2024-10-27,0,2,17,1,20,3
2024,21,São Paulo Grand Prix,interlagos,Autódromo José Carlos Pace,2024-11-03,3,2,15,0,20,2
2024,22,Las Vegas Grand Prix,vegas,Las Vegas Strip Street Circuit,2024-11-23,0,0,18,2,20,2
2024,23,Qatar Grand Prix,losail,Losail International Circuit,2024-12-01,0,5,15,0,20,5
2024,24,Abu Dhabi Grand Prix,yas_marina,Yas Marina Circuit,2024-12-08,0,2,16,2,20,4
